1112222111
1   3   41
1        1
2        1
233      2
3        3
24       2
3        3
13   1 141
1121115211